1 1 1 1 1 0 0 0 0 0
1 1 1 1 1 0 0 0 0 0
1 1 1 1 8 8 0 0 0 0
1 1 1 1 8 8 0 0 0 0
1 1 1 1 8 8 0 0 0 6
1 1 1 1 8 8 0 0 0 0
1 7 1 1 8 8 0 2 0 0
1 4 1 1 8 8 0 0 0 0
1 1 1 1 1 0 0 0 0 0
1 1 1 1 1 0 0 0 0 0
